dlluRdrUUUddrruuulL
Solved in 0.01 seconds.
Nodes Expanded: 489