uluRdrUUULuRdddlUULdlU
Solved in 0.09 seconds.
Nodes Expanded: 901