dlUdllUR
Solved in 0.00 seconds.
Nodes Expanded: 57