rurrdrrruuuLulDDDllldlluRRRRdRRdrUllUUUruulDllLdlDururrrDDDllldlluRRRRdRUUUddlllluuruulDDDuurrrRdddllldlluRRRRdrRdrruLLLUlllluuurrrrdrrdDuulluurDlllldlddrrrrUURuLLLrrdddlllluuuurDrrrddddrdrruLuuruLLullllldddrrrruUdddRdrUUUruLLuLLLLulDDDuurrrrrdrdddlluuUddllldlluRuuurrrRdddllLdlUUU
Solved in 208.25 seconds.
Nodes Expanded: 2285176