drrrrdrrddllUUruLLLulldRddrRlluuRRRdrrddlldlUrrruulluurDldDLddrUUUddrruuLuLDDuuLLulldRddRRdRUUruulDlLulDrrrDDlddrUUUrrddLruuluLLLrrddlddrUUUruLL
Solved in 2.08 seconds.
Nodes Expanded: 36378