dlldddllluurRllddrrrurrrruuuuuulllllldddRDrrruullDldRulluuurrrrrrddddddllllULrddlUUdrrrrruuuuuulllllldddrrDDldRuuuurrddLruulldlDDrUdddllluuRRllddrrUrULddlluuRRuuluuurrrrrrddddddllL
Solved in 54.70 seconds.
Nodes Expanded: 612624