LUUUluRddddLdlUUUUluR
Solved in 0.07 seconds.
Nodes Expanded: 1416