lluRRRRRllldlddddrrruurruuruulDlldLLulDDDDurUUrurrrDrddllldddlllluRuuuuuRRRRldllddlddRdrruuurrruulDrdLLruuruulDDDrdLuuulldllddlddrRdrU
Solved in 179.41 seconds.
Nodes Expanded: 2257646